15.ox
...o......o....o.o.....oo....o.o..o..o......o.....
..oo.o........o............o....o..............o..
..o.o....o....ooo.............o......o............
...o....o.........o........ooo...............o.o..
.....o...........o..o..ooo........oo..o.......o...
.o....o.....o......oo................ooo...oo...o.
...o......o......o.o.o....o..o......o...o........o
................o......o.........o....o...o.......
...o....o.o...o........o.oo.........oo..o..o.....o
......o..................o..o....o.........o....o.
o.o...oo.....o.ooo......oo........oo.oo.....ooo...
.o......o..o..............o.oooo..o...............
ooooo...o..o....o..o......o..................o.o..
.......oo.o....ooo..o....o............oo.....oo.o.
ooo...o...........o...............o..........o....
